00000000000
01311111310
01121112110
01311111310
01121112110
01311111310
01121112110
01311111310
01121112110
01311111310
03333333330
02111111120
01211111210
01121112110
01112321110
01113231110
01112321110
01121112110
01211111210
02100000120
03300000330
01210001210
02120002120
03330003330
